B97955155397
AC3A93853AC3
83C6AAC3A83A
AA956A9446C2
AC2FBC2FFF96
C3AFC5057FC3
92EFFFAFFFBA
AA917FAFD52A
82AC3FAFFF82
AC6BAD2913AA
AD1043EAAAAA
C56C7C546C46

0,2
9,9
WSESENNEEEEEESSESESWSESSSSSSWWNN