B939553915793
C6AA93AAA956A
93AAAAAAC6B92
AEC6AC6C556AA
853FC3BFFF96A
C7AFD4057FAD2
93AFFFAFFFC3A
AC2D3FAFD516E
83C16FAFFFC53
AA9693AD1553A
AAE96AA9693C2
AC3ABAAC3AC7A
C7C46C456C556

0,0
0,1
SEN